Frontend Routes
Logged Out
- '/'

Logged In
- Header (ROUTE) - Path: '/'
  - Logo - Link to= '/'
  - Search bar - Submit => Path: ''
  - Nav
    - Become a host - Link to='/newhome'
    - Saved - Link to='/users/:userId/favorites'
    - Trips - Link to='/users/:userId/trips'
    - Messages - Link to='/messages'
    - Help - Link to='/help'
    - ProfileImg - Link to='/user/:userId/profile'

- Main Content (ROUTE) - Path: '/'
  - Recommendations (ROUTE) - Path: '/' (PROTECTED PATH)
    - homes - Path: '/homes'
    - experiences - Path: '/experiences'
    - restaurants - Path: '/restaurants'

  - Continue Search (ROUTE) - PATH: '/' (PROTECTED PATH)
    - Previous Search - Path: '/users/:userId/latestSearch'

  - Airbnb Plus - PATH: ''
    - asdf

  - Recommended for you (cities)
    - Konoha
    - Whole Cake Island
    - Saboady

Search
- Header (ROUTE) - Path: '/'
- Filters ()
